+-+-+-+-+-+-+-+-+-+-+-+-+-+-+-+-+-+-+-+-+
####|   |   |           |   |     |     |
+-+#+ + +-+ +-+-+-+-+-+ + + + +-+ + +-+ +
|###| |       |   |   |   | |   | |   | |
+#+-+-+ +-+-+ + + + + +-+-+ +-+-+ +-+ + +
|#  |   |   | | |   |         |   | | | |
+#+ + +-+ +-+ + +-+-+-+-+ +-+-+ +-+ + +-+
|#| | | |     |       |   |   |#########|
+#+ + + +-+-+ +-+-+-+ + +-+-+ +#+-+-+ +#+
|#|   |     | |       | |   | |###|   |#|
+#+-+-+ +-+ +-+ +-+-+-+ + + + +-+#+ +-+#+
|#####| | |     |       | |   | |#| |###|
+-+-+#+ + +-+-+-+ + +-+-+ +-+-+ +#+ +#+-+
|   |#|   |  ###  | |###|  #######| |#| |
+ + +#+-+-+-+#+#+-+-+#+#+-+#+-+ +-+ +#+ +
| | |###  |###|#######|#####| | | | |#  |
+ +-+ +#+-+#+-+-+-+-+-+-+-+-+ + + + +#+-+
|     |###|#|   | |             |   |###|
+-+-+-+-+#+#+ + + + +-+ +-+-+-+-+-+-+-+#+
|        ###| | |   | | |###|#####  |###|
+ +-+-+-+ +-+ + +-+-+ + +#+#+#+-+#+-+#+ +
| | |   |     |     |   |#|###  |#####| |
+ + + + +-+-+-+-+ + +-+ +#+-+ + +-+-+-+-+
| |   |     |   | |   | |#|   |     |   |
+ + +-+-+-+ +-+ +-+-+ + +#+-+-+-+-+ + + +
| | |           |   | | |###|   |   | | |
+ +-+ +-+-+-+-+-+ + + +-+-+#+-+ + + +-+ +
|     |           | |   | |#|   | |     |
+-+-+-+ +-+-+-+-+-+-+-+ + +#+ +-+-+-+-+ +
| |     |             | |  #####|#####| |
+ + +-+-+ +-+ +-+-+-+ + +-+ +-+#+#+-+#+-+
| |     | |   |     |   |   |###|###|###|
+ +-+-+ + + +-+-+-+ +-+-+ +-+#+-+-+#+-+#+
|         |   |     |     |  #|###|#| |#|
+-+-+-+ +-+ +-+ +-+-+ +-+-+ +#+#+#+#+ +#+
|     |   | |   |   | |     |###|#|#|  #|
+ +-+ +-+ + + +-+-+ + + +-+-+-+-+#+#+-+#+
|   |   | |   |   |   | |   |  ###|###|#|
+ + +-+-+ +-+-+ + +-+ + +-+ + +#+-+-+#+#+
| |       |     |     |     | |#######|##
+-+-+-+-+-+-+-+-+-+-+-+-+-+-+-+-+-+-+-+-+