%%%%%%%%%%%%%%%%%%%%%%%%%%%%%%%%%%%%%%%%%
%P  %   %   %           %   %     %     %
%%% % % %%% %%%%%%%%%%% % % % %%% % %%% %
%   % %       %   %   %   % %   % %   % %
% %%%%% %%%%% % % % % %%%%% %%%%% %%% % %
% gG%   %   % % %   %         %   % % % %
% % % %%% %%% % %%%%%%%%% %%%%% %%% % %%%
% % % % %     %       %   %   %         %
% % % % %%%%% %%%%%%% % %%%%% % %%%%% % %
% %   %     % %       % %   % %   %   % %
% %%%%% %%% %%% %%%%%%% % % % %%% % %%% %
%     % % %     %       % %   % % % %   %
%%%%% % % %%%%%%% % %%%%% %%%%% % % % %%%
%   % %   %       % %   %         % % % %
% % % %%%%%%% % %%%%% % %%% %%% %%% % % %
% % %     %   %       %     % % % % %   %
% %%% % %%% %%%%%%%%%%%%%%%%% % % % % %%%
%     %   % %   % %             %   %   %
%%%%%%%%% % % % % % %%% %%%%%%%%%%%%%%% %
%           % % %   % % %   %       %   %
% %%%%%%% %%% % %%%%% % % % % %%% %%% % %
% % %   %     %     %   % %     %     % %
% % % % %%%%%%%%% % %%% % %%% % %%%%%%%%%
% %   %     %   % %   % % %   %     %   %
% % %%%%%%% %%% %%%%% % % %%%%%%%%% % % %
% % %           %   % % %   %   %   % % %
% %%% %%%%%%%%%%% % % %%%%% %%% % % %%% %
%     %           % %   % % %   % %     %
%%%%%%% %%%%%%%%%%%%%%% % % % %%%%%%%%% %
% %     %             % %       %     % %
% % %%%%% %%% %%%%%%% % %%% %%% % %%% %%%
% %     % %   %     %   %   %   %   %   %
% %%%%% % % %%%%%%% %%%%% %%% %%%%% %%% %
%         %   %     %     %   %   % % % %
%%%%%%% %%% %%% %%%%% %%%%% % % % % % % %
%     %   % %   %   % %     %   % % %   %
% %%% %%% % % %%%%% % % %%%%%%%%% % %%% %
%   %   % %   %   %   % %   %     %   % %
% % %%%%% %%%%% % %%% % %%% % % %%%%% % %
% %       %     %     %     % %       %.%
%%%%%%%%%%%%%%%%%%%%%%%%%%%%%%%%%%%%%%%%%